#########
#########
####.####
###xo.###
##xxx.###
##oxo..##
##.o..###
##@o#####
##..#####
#########
#########