########
#      #
#@o  #x#
# #    #
#      #
########