#########
######..#
######ox#
#...o.ox#
#.@ooxxx#
#.oooxx##
#..o.xx##
#########