########
#......#
#@o..#x#
#.#....#
#......#
########